TTTCACAACGCA	TTTCANAACGCA TTTCACAACGGA
TCCTTCTCCCAT	TCCTTCTGCCAT TCCTTCTCCCTT
TTGGAACGACTT	TTGGAACGACGT TTGGAACGGCTT ATGGAACGACTT TTGGAACAACTT
CCCTCTCGCCTC	CCCTCTCGCCCC
TATTGTTCGCCC	AATTGTTCGCCC
ATCAGGTTTCCA	ATCAGGTTTCGA
TGTCTGGGCCCA	TGTCTNGGCCCA
TATGATCTTCGG	TATGATCTCCGG TATGATCTTCGA
CATCCCCGCAAC	CAACCCCGCAAC
TACCCTGGCCTT	AACCCTGGCCTT TACACTGGCCTT
GAATTATAAGTT	CAATTATAAGTT
ACCGTTTCGTCT	ACCGTATCGTCT
TCCTGTGTGCCA	TCCTGTCTGCCA
CTCACCTCCCCT	CACACCTCCCCT
GTAGGGTGCCGT	GTAGTGTGCCGT
GTCGAACCTCGC	GACGAACCTCGC
CGCCCTAGTCAA	CGCCCTAGTTAA
CTCATTATCGGG	CACATTATCGGG TTCATTATCGGG
CTGAGATGTCTC	ATGAGATGTCTC
TAACACGGTTAG	AAACACGGTTAG
GTAGGGTGTCCA	GTAGGGTGTTCA
TTGGACTCTTTT	ATGGACTCTTTT TTGGACTCTTTA
CCAGGGTATAAC	CCAGGGAATAAC
AATTATGACTAG	GATTATGACTAG
GCCTTCACTCGG	GCCATCACTCGG
TACGCACACCCC	TACGCAAACCCC
ACATCTAACAAT	ACATCTATCAAT
GTCACCTAATCC	GACACCTAATCC
CTCATTTCTTCA	CTCATTTCTTCC
TATACTCACGTC	TATACTCTCGTC
AACCGTTTCCAC	AACCGTATCCAC
CCTTAGAAGGTC	CCTTATAAGGTC
CGCCACTATCTA	CCCCACTATCTA
TCGCTTCACTAT	TCGCTTAACTAT
GAATACCATGGC	GAATACAATGGC
GTCGGGGCGGGC	CTCGGGGCGGGC
ATGGTTCATTTG	ATGGATCATTTG
CCGCAAAAAACG	ACGCAAAAAACG CCGCANAAAACG
TGTCTGAAGCTC	AGTCTGAAGCTC
GCCCTCCATCCA	GCCCTCCAACCA
TAAATGAACCAC	TAAATGAATCAC GAAATGAACCAC
TATCATACAAAC	AATCATACAAAC
CATTGGCCCACG	CAATGGCCCACG
ACCTAATCTTCA	ACCAAATCTTCA
GCCAGGGTCGTC	GCCGGGGTCGTC GCCAGGGTCGTG
CCCTCCTACTGC	CCCTCCTGCTGC
AACTTACTCGAC	AACTTACTCGAG AACTAACTCGAC
TCAGTAACCATG	TCAGGAACCATG
TTACAGACGCGA	TTACAGACGCGG ATACAGACGCGA
CAAGCGTTTCTT	CAAGCGCTTCTT CAACCGTTTCTT
TGAACGACGGTT	CGAACGACGGTT
TCGCCATTGCGC	ACGCCATTGCGC
GACCTAGGTACA	GGCCTAGGTACA
TCCTCCGCCTTT	TCATCCGCCTTT TCCTCCGCCATT
TCTGGACCCCCA	ACTGGACCCCCA
ACGACTGTCAAC	ACGACTGTCAAA ACGACTGTCCAC
CTTCCTATGCTG	CTTCCTATGATG
AATTAGGGCCGT	AATCAGGGCCGT ATTTAGGGCCGT
ATATCCCGGCCG	ATATCCCGGCCC ATATCTCGGCCG AAATCCCGGCCG ATATCCCGGCAG
TGCCCTTCCCTT	TGCCCTTCACTT
TATTACGCATCC	TATTAAGCATCC
ATGGCCTTTGCG	ATGGCCTTAGCG
CACTTTACCAGC	CACTTTACCAGA
ACCCACGCGTCC	ANCCACGCGTCC
TTACGCCGCAGT	TTACGCCGCAGG ATACGCCGCAGT
GCACCCGCGCCC	GCACCCGGGCCC GCACCCGCGCAC
CTCTTCATTCTT	CTCTTAATTCTT
TCGCAACGACGA	ACGCAACGACGA
GTGGACACCGTA	GTGGCCACCGTA
CCTACAATGGCT	CCTACNATGGCT
CTAGAAACCTAG	CTAGAAAACTAG
CGTTGCCAATGT	CGTAGCCAATGT
TGCGGGATCCCG	TGCGGAATCCCG
TTCGAACACCAA	TTCGAACACAAA
CAAGGATTTATG	CAAGGAATTATG
TCGCATCCTTCG	ACGCATCCTTCG CCGCATCCTTCG
ACAACGAGCACA	ACAACGAACACA ACAACGAGCTCA
CTGTCGCCCACT	CTGTCGCCCACA
TGCTCACTGATC	TGCACACTGATC TGCTCTCTGATC TGCTCACTAATC
TGCGCTTCCGGT	AGCGCTTCCGGT
TTTGTAGGCGGT	TTTGAAGGCGGT TTTGTAGGCGCT
TTGCACATTCTC	TTGCACATTCGC
TACGTTCGCGAC	TACGATCGCGAC TACGTCCGCGAC
GTCTATGCCTCA	GACTATGCCTCA
AAGACACTCTGA	AAGACACTCTTA
TTCAGTACTCCA	TTCAGTACTCAA ATCAGTACTCCA TACAGTACTCCA
TTGCTCGCCTCG	ATGCTCGCCTCG TTACTCGCCTCG TTTCTCGCCTCG
TCTAAGATCCAG	TCTAAGAGCCAG TCTAAGATCAAG
TCATGTGAATTA	ACATGTGAATTA TCATGTGAATTG
GCAAAGTTTTCA	GCAAAGTGTTCA GCAAATTTTTCA
AAAGTTCTATCC	AAAGTTCTATCT
TTCCTGGTAGTG	TTCCAGGTAGTG
CATGTATCCTAG	CAAGTATCCTAG
AACGACAGCTGG	AACGACAGCTAG
CTTCCGGTCACC	CTTACGGTCACC
CGCTTTTTGAAA	CTCTTTTTGAAA
CTACACTCCTGG	CTAAACTCCTGG
CAATACATCGTC	CAATACATCGGC
TCCAACAGCGTC	ACCAACAGCGTC
CATACGGTAGTC	CATTCGGTAGTC
GTCGCAGTCTAA	GTCGCAGTCAAA
GGAAAGCCGACC	NGAAAGCCGACC
TCGCGGGTAATC	TCGCGTGTAATC
TACGCTGTACCA	TACGCTGTAGCA AACGCTGTACCA
TCCATCACATTC	ACCATCACATTC TCCATCACATAC
GCCCAATTTTCG	CCCCAATTTTCG TCCCAATTTTCG
AGCGCGTATCCC	AGCGCGTATCCG AGCGCGTAACCC
CTGGGCCCGTCC	CTGGGACCGTCC
CATTAGACCCCC	AATTAGACCCCC CATGAGACCCCC
CATAATACTACA	TATAATACTACA
CCATCGGAACCC	CCATCGGAANCC
CAATTCGCACCC	CAATTNGCACCC CAAATCGCACCC
CCGTCCAGGATT	CCGTCCAGGAAT
TAGTCAAGAACA	AAGTCAAGAACA
ATGTCTGTTGTC	TTGTCTGTTGTC
CGCCTCCGACCC	CGCCTCCGACGC CGCCTCAGACCC CGCCACCGACCC CGCCCCCGACCC
GGAACTGGCTGC	GGAAATGGCTGC GGAACTGGCAGC
CCCCCCACCTTC	CCCCCCACATTC
ATAACGCGAAGG	ATAACACGAAGG
GATTAAGGGTTA	GATTTAGGGTTA
AGGGGCTACAAT	AGGCGCTACAAT
CGTTAAACGCCT	CGATAAACGCCT
GAACCTACCCTC	GAACCTATCCTC
CACATCTTCACT	CAAATCTTCACT CACATCTACACT
TCAGGCCAGTCC	ACAGGCCAGTCC TCAAGCCAGTCC
AGTTGCGCTCAT	AGTTGCTCTCAT
CACCGTATTAAC	CACCTTATTAAC CACCCTATTAAC
AACACTACAACC	AACACTACAAGC
CCCGCCCAAGAA	CCCGACCAAGAA CCCGCCAAAGAA
AAAGACTGCGTC	AAAGACTGCGTG
AGGGCCCACATA	AGGGCCCACATG
GCTTACATGCAT	GCTTACATGCAG
AACCAAAGTACG	AACCAAACTACG
TGCGAGTCTACC	TGCGAGTCTAGC TGCGAGTATACC AGCGAGTCTACC TGCGAGTCTTCC TGCGAGTCNACC TACGAGTCTACC
GTGCATAGTCCC	GAGCATAGTCCC GTGCATAGTCCG
TCCCTCCGCCTA	TCCCTCCGCATA
TAACATGCAGGC	TAACATGCAGGA
TCGTTTCCCTCT	TCGATTCCCTCT
CTACCGTCAAGA	CTACCGTCAACA
CATACGGCTTCT	CATACGGCCTCT
GATGGGATTTCT	GATGAGATTTCT GATGGGATTTCA
TTCCATTGGTTC	ATCCATTGGTTC TTCCATAGGTTC
GCCTATCGGGCA	GCCTATCGGGCG
CGGTTCCGTATG	CGGTTCCGTTTG CGGTTCCGAATG
TTTTGAATCCGT	ATTTGAATCCGT TTTTGAATGCGT
TTGGACGTCTCA	TTAGACGTCTCA
CCATAGGTTTTC	CCAAAGGTTTTC
TTCCCGCGTCAG	NTCCCGCGTCAG
CAGCTCCTATCG	CAGCTCCTATAG
CATTCCGTTACT	CATTCCGATACT CATACCGTTACT CATTACGTTACT
AAACTTCTCCTG	AAACTTCACCTG AAACTTCTCCAG
CCTAATACTCTA	TCTAATACTCTA CCTAAAACTCTA
GTTCACTCCCCC	GTACACTCCCCC
CACCACGTAACC	CACAACGTAACC CATCACGTAACC
TATAGAGGCACC	TATAGAGGCACA TATAGAGGCACT
ACGATTATTTCC	TCGATTATTTCC
CGCAAGCTTTAC	CACAAGCTTTAC TGCAAGCTTTAC
CAGGGAAATTGG	CAGGGAAAATGG
GTACCTATCCTC	GTACCTATCCAC GAACCTATCCTC
GACACAAACCCA	GAAACAAACCCA
GGCACCCGAAAA	GGCACACGAAAA GACACCCGAAAA
TCAAACATCAGA	ACAAACATCAGA
GAGGACCGTCAT	GAGGACCGTCAG
CCCAAACCCGCA	CCCAAACCCGGA
GATAAATGCGCC	GATAAAAGCGCC
CAACGCGTTGCC	CAACGCGTTGTC
AATCACCTCGAG	AATCACCTCGAC
GAACCGCCGAAT	CAACCGCCGAAT AAACCGCCGAAT GAACCGCCGAGT GAACCGACGAAT
CGCCACACTAGG	CGCCACACTAGC
TGTTCACGCCGC	TGTTCACGCAGC
GGGTCGTAGATT	GGGTCGTAGNTT
TCCTTCTCCAAA	TCCATCTCCAAA
CCGATCACCCCA	CCGATCACCACA
CTCCCGGGAGGC	CTCCCGGGAGGG CTCCCGGTAGGC
TAATCTCTTAAT	TAATCTTTTAAT
TCTGGTCGGCGC	ACTGGTCGGCGC
TCGTCTCTAGGT	ACGTCTCTAGGT
GGGCCTACTAGG	GGACCTACTAGG
GACGCTTGAACT	GACGCTAGAACT
GTTGCAATCCCT	GTTGCAATCCGT GTTGCAATCCCG
GTTTAACACCTG	GTATAACACCTG
CGCCCAACAGCG	CGCCCAACATCG
TTCATAGTCACC	ATCATAGTCACC
TCAAAATATTTA	TCAAAATATATA ACAAAATATTTA TAAAAATATTTA
TCACCCGCTGTC	TCACCCGCTGGC TCACCCGCTTTC
TGAAAATGACAT	AGAAAATGACAT
TCTTCCTACGGT	TTTTCCTACGGT TCATCCTACGGT CCTTCCTACGGT
TATCTACTCGGT	AATCTACTCGGT
TCAGTGCGGATC	ACAGTGCGGATC
AAATCGGATTAG	AAAACGGATTAG
ACCCACAACATC	ACCCACAACAAC
ATCTCTTAATTG	ATCACTTAATTG
CCTTTTCGAGCC	TCTTTTCGAGCC
GAACACTTCCCC	GAACACTTGCCC GGACACTTCCCC
CTATACCCGAGT	CTAAACCCGAGT
CAGCATCCAGCG	CTGCATCCAGCG
CGCATGGCCGCA	CGCATGGCCGTA
TCAAATCCTATA	TAAAATCCTATA TCAAATCCTAGA TCAAAGCCTATA TCAAATCCTAAA ACAAATCCTATA
CTTACTAACTCG	CTTGCTAACTCG
AGTCATATTCTA	AGACATATTCTA
GAGTGCGTCACC	GAGTGCGTTACC GAGTGCGACACC
TACACAAGGCGT	TACACAAGGAGT
CACTTCTCTTGG	CACTTCTCTTAG CACTTCTCATGG CACATCTCTTGG
CTCCGTGTACCA	CTCCGTGTACCG
TAGGCTCCCGAG	TACGCTCCCGAG
ACCTTATCTTCT	GCCTTATCTTCT ACCTTAACTTCT
ACTGGAGTCTCA	ACTGGAGTCTCG
CAATATCTCGAC	CAATAACTCGAC
CCACTTACACTT	CCACTAACACTT
CGGTTATCTTCT	CGGTGATCTTCT
GCATAGTGCATA	GCATAGAGCATA
TATGCACCCCAA	AATGCACCCCAA
TTAGGCTAGGAC	ATAGGCTAGGAC
TTAGTACGGCGA	TTAGTACGGAGA
ACTATTACACAG	ACTAATACACAG
ATTTAAAAAGTC	ATATAAAAAGTC ATTTAATAAGTC
CTGTCCTCTACG	CTGTCTTCTACG
CCCATTCACTTG	CCCAATCACTTG
CAAAGTCCCCAT	CAAAGTCCCCTT CAAAGTCCCCGT
CACCCAACTGTG	CACCCAACTGTC CACCAAACTGTG
AATTAAGGCAAA	AATTANGGCAAA
TCGAATGGCTTT	TCGAANGGCTTT
TACCATCGCCCT	TACCANCGCCCT
TGATCCGTAACA	TGATCTGTAACA
GCACGCGTGAAA	GCACGAGTGAAA
CAAATTAACGCC	TAAATTAACGCC
GGCCGGACCCCA	GACCGGACCCCA GGCCGGAGCCCA
TTGCCCTGGTAA	ATGCCCTGGTAA
GGTTATTATTAG	GGTTANTATTAG
TCCGTGACACCT	TCAGTGACACCT
CTAAGCCTCCGG	CTAAGCCTCCGT CAAAGCCTCCGG
ACCACCATAGTA	ACCACNATAGTA ACCAACATAGTA
GCCATTCGTCGT	GCAATTCGTCGT
GGGATAGTGTTT	TGGATAGTGTTT GGGATAGTGTAT
ACTGTCACTCAT	ACTCTCACTCAT
ATTCTGTACCAC	ATTCTCTACCAC
GGTTCCAGCCTT	GGTACCAGCCTT
TACTATCCACAC	TACTATCCACCC TACTATCCACAG
TCCTCCACAAAC	ACCTCCACAAAC TCCTCCACAATC
TACTTTCTTACT	AACTTTCTTACT TACGTTCTTACT
ACTTGTATTAAA	ACTAGTATTAAA
TTGGATGAGCTG	ATGGATGAGCTG CTGGATGAGCTG
TTCCCTCCCTGT	ATCCCTCCCTGT TTCCCTCCCAGT TTCCCTCACTGT
GCCCATCGAGCT	GCGCATCGAGCT GCCCATCGATCT
TCTCTGTATCTC	TCTCTGTATCGC TCTCTGTATCAC
AGGCCAAGATCT	AGGCCAAGAACT
CATTATTAGCAC	CAATATTAGCAC CATTAATAGCAC CATAATTAGCAC CATTATTACCAC
CACTGGGGCATC	CACTGNGGCATC CACTGTGGCATC
GGTCTCGTGGTA	GATCTCGTGGTA
TCGTGGTTCACA	TCGTGCTTCACA
ATTTATTTCGGC	ATTTATTCCGGC
GATCACCCAGCG	GATCACACAGCG
AAGCATTCTCTG	AAGCATTCTCGG
ACTTCTCTCCCG	ATTTCTCTCCCG
TGAAGCCCGTTA	AGAAGCCCGTTA TGNAGCCCGTTA
TGTGGGCCCCAG	AGTGGGCCCCAG
GGGATCCGCCCT	GGGATCAGCCCT
AACACGGCCCCG	AAAACGGCCCCG AACACTGCCCCG
ACTCCCCTCCAC	ATTCCCCTCCAC ACTCCCCTCCAT
GATCTCCCAGGA	CATCTCCCAGGA GATCTCCCAGAA
CTAGTTTTTTAC	TTAGTTTTTTAC
TACCCCTGACCT	AACCCCTGACCT
TAGAGCCAACCA	AAGAGCCAACCA
TAACAACGTCGA	AAACAACGTCGA TAACAACGACGA
AAACAACGTCGA	AAACAACCTCGA
TCAAACGTAGCG	TCAAACGAAGCG
CTAACGACGCCA	CTAACGACGCCT
GGCAAACCAAAT	CGCAAACCAAAT
CCCTACGCCCTT	CCCTACGCCCTG CCCTACCCCCTT
ACCCCACCAGGA	NCCCCACCAGGA
ATTGACGCATTT	AATGACGCATTT
TATAGAGGCACT	TATAGAGGCACA
CAAAGTCCCCTT	CAAAGTCCCCGT
CCCGTTTTGGCT	TCCGTTTTGGCT CCCGGTTTGGCT CCCGTTATGGCT CCCGTTTTGGCG
CGCAATTACATC	CGCAATTACATA
CTCGGATCCCGT	CTCGCATCCCGT CACGGATCCCGT
TCGGGACGCCGC	TCGGGAAGCCGC
CACTGGGATTTG	CACTTGGATTTG CACAGGGATTTG CACTGGGATATG
ACATTTATTGTC	ACATATATTGTC
ACTGTAGCCAAT	ACTGTAGCCAGT ACTGAAGCCAAT TCTGTAGCCAAT
TCACTTTGTACC	TCATTTTGTACC
CTGGCCCCCCTC	CTGACCCCCCTC CTGGCCCCCGTC
CAGCCCGTTTAC	CGGCCCGTTTAC
ACAGGGGGCGAC	ACAGGGGTCGAC
TCGACGACGGGC	TTGACGACGGGC ACGACGACGGGC
TCCGCCTCCGTG	TCCGCATCCGTG
ATCGCCTGCTTC	AACGCCTGCTTC
GTAGTTCTACAC	GTAGTTTTACAC GAAGTTCTACAC
GACCAGTCTAAT	GACCAGTATAAT
CACGGCCTAACC	GACGGCCTAACC
ACGATGATCATC	ACGAAGATCATC
TGAGCAATCTGT	TAAGCAATCTGT
TCGATACTTCAT	TAGATACTTCAT ACGATACTTCAT
ACCTCTTGATAT	ACCTCTTGATGT
CATTCGACCACA	CATACGACCACA
TCTCCTTTTAAT	GCTCCTTTTAAT
TTTTGGACCTCC	ATTTGGACCTCC
CTGAGCATAGCA	CTGAGCATAGGA
CTTTACCTTGCT	CTTTACCTCGCT
TGTTCAACTGTC	TGCTCAACTGTC CGTTCAACTGTC
CACGGTCCGACT	CACGGTACGACT CACGGTCCGACC
CGCAATGCTATA	CGCAATCCTATA
CCTAAGTAGATC	CCTAAGTAGAAC
TATACCTATATA	AATACCTATATA
CTTGGAGGCAAC	CTTGGNGGCAAC
GTCGATCAGGCT	NTCGATCAGGCT
CTTATTTGTGGT	CTTATATGTGGT
TCGTATGCCTCC	TCGTATGCCTCG
CCATCGGCCTAC	CCATCGGCCTGC
GCGGCTTGTGAG	GCGGCTTGTAAG
AGGGCCTATTAT	ATGGCCTATTAT GGGGCCTATTAT
CATACCAGTGAT	CAAACCAGTGAT CATACCAGTTAT CATACCAGTGAG
TCTGATTTCCTG	TCTGATTTCCTC
TCCTACCAATTC	TCCAACCAATTC
TCTCACTCGAGC	ACTCACTCGAGC
GCGCAGTTCATT	GCGCAGTTCATG
AAAACGATATGC	AAAATGATATGC
TATACAAGCCAA	AATACAAGCCAA TAAACAAGCCAA
CTCCCACTTAAT	CTCCCGCTTAAT
CATGGCGAGCAT	CATGGCGAGCCT CATGGCTAGCAT
CATGGCGAGCCT	CAAGGCGAGCCT
CAGCTACCATAG	CAGCAACCATAG
CCCGCAACCGTA	CCCGCAACTGTA
CTGCAAACCGCA	CTGCAAACAGCA CTGCATACCGCA
TATTAGCTCACT	TATTAGCTCGCT
TATTAGCTCCCT	TATTAGCTCACT TATTAGCTCGCT
TGGTGTAGATTC	TGGTGTTGATTC
ACATCCATATTC	ACATCCATAATC ACATCCAAATTC
CCCCAATTTTCG	TCCCAATTTTCG
GCATCGCAACGT	GCATCGCAANGT GCATAGCAACGT
GTTACGCTTCGC	GTGACGCTTCGC GGTACGCTTCGC
CTTCTGAGACCT	CATCTGAGACCT
TCCTTACGTCAT	TCCTTACGTCAG
CTGTTTATACCT	CGGTTTATACCT CCGTTTATACCT
CCTCACCCATAA	CCTCAACCATAA
TCTGTCTATCAT	ACTGTCTATCAT
CAACCGCCGAAT	AAACCGCCGAAT
ACTTATCTGGAT	ACTTATCTGGAG
TTTTTTATGGCA	ATTTTTATGGCA
GGAATCAAGGTC	AGAATCAAGGTC
GTTAACTCAAAA	GATAACTCAAAA
TTCTGGGTACTC	TTCTAGGTACTC TTCTGGGTACTG
TTCGTTGTCAGC	TTCGTTGTCAGG
ACACGATACCCG	ACACGATACNCG
CTGATTATCATT	ATGATTATCATT
CACTCGCAGCTG	CCCTCGCAGCTG
GCCAATTGTTGC	GCCAATTGTAGC
ACGTTACGACCA	ACGTAACGACCA ACGTTACGACTA ACGTTACGANCA
TACCAGTTCTCC	TACAAGTTCTCC AACCAGTTCTCC
GGCTACCCTTTA	GGATACCCTTTA
CTCTATCAATGC	CTCGATCAATGC
TCCAAGACTTCT	TCAAAGACTTCT
ATGGTCGCCCGA	ATGGACGCCCGA
TAGTTTTTTGGT	TAGTTTATTGGT
GACAGGTTCCAC	GACAGCTTCCAC
AACCAGTTCTCC	AACCAGTACTCC
TGTACTTACTCT	AGTACTTACTCT
CTTGCCTCTGGA	CTTGCTTCTGGA GTTGCCTCTGGA
TATCTCGCCTTT	TATCTCGCCTAT
GTTCCCTACCTG	GTTCCCTACATG
TTACTCGCCTCG	TTTCTCGCCTCG
TACAGCTTACAC	AACAGCTTACAC
TATGAGTGCTAG	AATGAGTGCTAG
CATTCACGTTCA	CATTCACGTTGA
CACCTTCGCGCA	CCCCTTCGCGCA
CACCGCATCTCA	CACCGCACCTCA
CTGGATGAGCTG	ATGGATGAGCTG
CGCCCCCGACCC	CGCCACCGACCC
GCTACCACACCA	GCTACCACACAA
ATCAGAACTTAC	AACAGAACTTAC
AGTTAAGACCTT	AGTTAAGACTTT AGTTAAGACGTT
CGACAATAGGCT	CGACAATACGCT
AGTACATACTCT	AGTACTTACTCT
ATGTATCTGGTC	ATGTATATGGTC
CACCCTATTAAC	CACCTTATTAAC
TACGATCGCGAC	AACGATCGCGAC
CCTTCTAGTGTG	CCATCTAGTGTG CCTTCTAGTCTG
CGTCAAAATACT	CGACAAAATACT
CTTAAAGCACCC	CTTAAAGCTCCC
ACAAAATATTTA	ACAAAAAATTTA ACAAAATATTAA
ATAGGCACCCTT	AAAGGCACCCTT
CCCTCTGCACTA	TCCTCTGCACTA
AACAGCCCCTAT	TACAGCCCCTAT
CATTACCTTGTC	CATTACCTTTTC AATTACCTTGTC
ACGACGACGGAC	ACGACGACGGGC
TAAGCAATCTGT	TGAGCAATCTGT
TGCCTCCTTAGT	AGCCTCCTTAGT
AACGATCGCGAC	TACGATCGCGAC
AGCTAGTCCAAA	AGCAAGTCCAAA AGCTAATCCAAA
ACGCATCCTTCG	CCGCATCCTTCG
TATAGAGGCACA	TATAGAGGCACT
CACTGTGGCATC	CACTGNGGCATC
AAACCGCCGAAT	CAACCGCCGAAT
TAAACGTGGTTG	TAAACGTCGTTG
GCATAAATGTCC	GCCTAAATGTCC
TACAGCCCCTAT	AACAGCCCCTAT
TCCAAATTTTCG	TCCCAATTTTCG
CAATTAAACAAC	CAATTAAACAAG
CAACTGGCAGTT	CAACTGGCAGTG
CGCCACCGACCC	CGCCCCCGACCC
CAATTAAACAAG	CAATTAAACAAC
ATGGATCATTTG	ATGGATCAATTG
CACAAAGTAACC	CACAACGTAACC
GTACCTATCCAC	GAACCTATCCAC
TCTTCCTTAGTA	TCCTCCTTAGTA
GAACCTATCCAC	GTACCTATCCAC GAACCTATCCTC
TCCACCGCGCAT	TCCACCGCCCAT
AGTTAAGACGTT	AGTTAAGACTTT
TATACTCTCGTC	TATACTCACGTC
GCTTGACCGAGT	GCTAGACCGAGT
CACTGNGGCATC	CACTGTGGCATC
AACCGTATCAAC	AACCGTATCCAC
CCCCCCACATTC	CCCCCCACATAC
ACATCTATCAAT	GCATCTATCAAT
TTTCTCGCCTCG	TTACTCGCCTCG
CCCCCCACATAC	CCCCCCACATTC
CTTAAAGCTCCC	CTTAAAGCACCC
AACCGTATCCAC	AACCGTATCAAC
GCCTAAATGTCC	GCATAAATGTCC
CCGTTTATACCT	CGGTTTATACCT
CGGTTTATACCT	CCGTTTATACCT
AACCAGTACTCC	AACCAGTTCTCC
GAACCTATCCTC	GAACCTATCCAC
TATTAGCTCGCT	TATTAGCTCACT
ATGGATGAGCTG	CTGGATGAGCTG
AGTTAAGACTTT	AGTTAAGACGTT
TCTCTGTATCAC	TCTCTGTATCGC
CACAACGTAACC	CACAAAGTAACC
CAAAGTCCCCGT	CAAAGTCCCCTT
TCAAATCCTAGA	TCAAATCCTAAA
TCCATCACATAC	TCCATAACATAC
TCCATAACATAC	TCCATCACATAC
TCCCAATTTTCG	TCCAAATTTTCG
AGTACTTACTCT	AGTACATACTCT
ACGACGACGGGC	ACGACGACGGAC
GCTAGACCGAGT	GCTTGACCGAGT
GGCCGCTTTAAA	GGCCGCATTAAA
TTCGTATCGGAA	TTCGTATCGGAT
ACGTGATTGCAA	ACGTGATTTCAA
CCCCAGGTCTGA	CCCCAGGTCTGT CCCCAGGTCTGG CCCCAGGTCTGC
TCTCTCCCTACA	TCTCTNCCTACA
TTGCCCCGCTTA	TTGCCCCGCTTG
CGCTGTATGGTA	CGCTGTATGGTG GGCTGTATGGTA
CATCACCCGTGA	CATCCCCCGTGA
TGGTCGACCGAA	GGGTCGACCGAA AGGTCGACCGAA
TCGGACTTGAGA	TCGGACTTTAGA
TGTTCGATTCCA	TGTTCGATTCCG AGTTCGATTCCA
CGTCACGTACTA	CTTCACGTACTA
CCCTCTCGTTTA	TCCTCTCGTTTA CCCTCTCGATTA
TTCTCGGATTGA	TTATCGGATTGA
CCAGTCTCAGTA	CCAGACTCAGTA
CGATTGTCCCAA	CCATTGTCCCAA
TATTCCGAACCA	TGTTCCGAACCA
CCTGCCTATTCA	CCTGCCTATACA
GCTAATTCAATA	GCTAAATCAATA
GCAAGCCCATGA	GCAAGCCAATGA
GCGCTGCGATCA	GCGCAGCGATCA
CTCGGAAACCAA	CTCGGAAACCAG
GGCCTATCTCCA	GGCCTATCTCAA
CAAAAATGAATA	CAAAAATGATTA
CTCCCAATCCAA	CTCGCAATCCAA
TCCCGATTGCCA	TCCCGATTGCGA ACCCGATTGCCA
GACCTAACCCCA	GACATAACCCCA
AACACGATCCCG	AACACGATCCCC
TTCGTTTCTCGC	TTCGTTTCTCGT
TCCCTGCATCCA	TCCCTACATCCA
ACACTCGTAGTA	ACACTTGTAGTA ACACACGTAGTA NCACTCGTAGTA ACAATCGTAGTA
CGAGAAAGTTTA	CGAGAAAGTATA
TTGCTCCTTTAA	ATGCTCCTTTAA
TATATTGAATCA	TATATTGAGTCA
TCCTTCGACAAA	ACCTTCGACAAA
TGTTTCCCTTCA	TGTTTCCCTGCA
TTTTACAATGTA	ATTTACAATGTA TTATACAATGTA
CTCCACATGTCA	CTCCACATTTCA CACCACATGTCA
GGTCTTTCAATA	GGTCTTTCAAGA
TACTTCCTTCAA	AACTTCCTTCAA
TACAAGGGCCCA	AACAAGGGCCCA
TCGTCGCGACCA	ACGTCGCGACCA TCGTCGCAACCA
ATAAATGGCTCA	AAAAATGGCTCA
TACTCCCGCTAA	AACTCCCGCTAA TACACCCGCTAA
AGATGACCAAGA	AGATGATCAAGA
TATCTTAGCCCA	TAACTTAGCCCA
CCTCACCCGGCG	CCTCCCCCGGCG CCTCACCCCGCG
ACAGCCCCGGCA	CCAGCCCCGGCA ACAGCCTCGGCA
CGCGGCCGCGTA	TGCGGCCGCGTA
TCCTACTAGTGA	TCCTACTAGTTA TCCTACTACTGA
CGGATGTTTCAA	CGGATGATTCAA
CATATCTTTGTA	CATAACTTTGTA
GCGATTCTGACA	GCGATTCTGAGA GCGATTCTTACA
CCGGAGCCTTGA	TCGGAGCCTTGA
TCGGCGCTAACA	TAGGCGCTAACA
GGGTCGACCGAA	AGGTCGACCGAA
TCAAATCCTAAA	TCAAATCCTAGA
AGGTCGACCGAA	GGGTCGACCGAA
CACCACAAGTCA	CACCACATGTCA
TCCTCCTTAGTA	TCTTCCTTAGTA
CTGACGTCTCAA	CTGACGTCTCTA
CCCCAGGTCTGT	CCCCAGGTCTGG CCCCAGGTCTGC
AATGAGTGCTAG	AAAGAGTGCTAG
CTGACGTCTCTA	CTGACGTCTCAA
CACCACATGTCA	CACCACAAGTCA
TCTCTGTATCGC	TCTCTGTATCAC
TAGGCGCTAACA	TCGGCGCTAACA
CCCCAGGTCTGG	CCCCAGGTCTGT CCCCAGGTCTGC
CCCCAGGTCTGC	CCCCAGGTCTGT CCCCAGGTCTGG
AAAGAGTGCTAG	AATGAGTGCTAG
TTCCCACACAAT	TTACCACACAAT
TACGGGACGATG	AACGGGACGATG
TTCATTATTAAT	TTCATTATTAAA
CCCGACCGAATG	CCCGACCGAATA NCCGACCGAATG
TAATATCCTCAT	TAATATACTCAT
CTAGGCCCGATG	CTAGGGCCGATG
ATCATTTTGATG	ATCATTCTGATG ATCATTTTGATC TTCATTTTGATG
TGGTACTGAGAT	AGGTACTGAGAT TGGAACTGAGAT
GTTATTTTAGAT	GTTATTTAAGAT
GTCCCCCTTAAT	GTCCCCCTAAAT
TGCATGCGGCAT	TGCATGCGGGAT
CAGCATACTTAT	CAGCATACTTAA CATCATACTTAT
TGATAAATGTAT	TGATAAATGTGT
TACCCATGTCAT	AACCCATGTCAT
ATGACGCCTCAT	ATGACGCCGCAT
TACACGGAAACT	AACACGGAAACT
GACGCCACGGAT	GCCGCCACGGAT
CAGCCTCTACAT	TAGCCTCTACAT CAGCCACTACAT
GCAAATGCCAAT	GCAAATGCCTAT
ACTCCATAGAAT	ACTCCATTGAAT
CCTGGTTTCTAT	CCTGGTATCTAT
CCGCTGCGATAT	CCGTTGCGATAT
GCCCAACGCTTT	GCCCAACGCTAT
CTAAAGTGGGAT	CAAAAGTGGGAT
TTCCCGCTTCAT	TTCACGCTTCAT
CACGAACCCTAT	CACGAACCGTAT
TGACCGACCCAT	TGACCGACACAT
CTCGGGCCTATG	TTCGGGCCTATG CACGGGCCTATG CTCGCGCCTATG
TTCGCCTTCATG	TTCCCCTTCATG
CCTTCTCTAATG	CCTTCTCTAATC CCTTCTCAAATG
CACGTCGACCTG	CACGTCGACCGG
ACATCTCTCATG	ACATCTCTCAGG
CGAAACCAAATG	CCAAACCAAATG
TAACACACGATG	AAACACACGATG TAACACACGAAG
TCCGCGAACCAT	ACCGCGAACCAT
GACTCGCGATGG	GACTCGGGATGG
GTGAACTAATGG	GAGAACTAATGG GTGAACTAAAGG
TGGCTTGGAGCG	TGGCTTGGAGGG
GCACCTACATGG	GAACCTACATGG
CACCAACTATGG	CACCAACTATGC
ATGGATCAATTG	ATGGATCATTTG
