TTTCACAACGCA	TTTCACAACGGA TTTCANAACGCA TTTCANAACGCA TTTCACAACGGA
TCCTTCTCCCAT	TCCTTCTCCCTT TCCTTCTGCCAT TCCTTCTGCCAT TCCTTCTCCCTT
TTGGAACGACTT	TTGGAACGGCTT ATGGAACGACTT TTGGAACGACGT TTGGAACAACTT ATGGAACGACTT TTGGAACAACTT TTGGAACGGCTT TTGGAACGACGT
CCCTCTCGCCTC	CCCTCTCGCCCC CCCTCTCGCCCC
TATTGTTCGCCC	AATTGTTCGCCC AATTGTTCGCCC
ATCAGGTTTCCA	ATCAGGTTTCGA ATCAGGTTTCGA
TGTCTGGGCCCA	TGTCTNGGCCCA TGTCTNGGCCCA
TATGATCTTCGG	TATGATCTCCGG TATGATCTTCGA TATGATCTCCGG TATGATCTTCGA
CATCCCCGCAAC	CAACCCCGCAAC CAACCCCGCAAC
TACCCTGGCCTT	TACACTGGCCTT AACCCTGGCCTT TACACTGGCCTT AACCCTGGCCTT
GAATTATAAGTT	CAATTATAAGTT CAATTATAAGTT
ACCGTTTCGTCT	ACCGTATCGTCT ACCGTATCGTCT
TCCTGTGTGCCA	TCCTGTCTGCCA TCCTGTCTGCCA
CTCACCTCCCCT	CACACCTCCCCT CACACCTCCCCT
GTAGGGTGCCGT	GTAGTGTGCCGT GTAGTGTGCCGT
GTCGAACCTCGC	GACGAACCTCGC GACGAACCTCGC
CGCCCTAGTCAA	CGCCCTAGTTAA CGCCCTAGTTAA
CTCATTATCGGG	TTCATTATCGGG CACATTATCGGG TTCATTATCGGG CACATTATCGGG
CTGAGATGTCTC	ATGAGATGTCTC ATGAGATGTCTC
TAACACGGTTAG	AAACACGGTTAG AAACACGGTTAG
GTAGGGTGTCCA	GTAGGGTGTTCA GTAGGGTGTTCA
TTGGACTCTTTT	TTGGACTCTTTA ATGGACTCTTTT ATGGACTCTTTT TTGGACTCTTTA
CCAGGGTATAAC	CCAGGGAATAAC CCAGGGAATAAC
AATTATGACTAG	GATTATGACTAG GATTATGACTAG
GCCTTCACTCGG	GCCATCACTCGG GCCATCACTCGG
TACGCACACCCC	TACGCAAACCCC TACGCAAACCCC
ACATCTAACAAT	ACATCTATCAAT ACATCTATCAAT
GTCACCTAATCC	GACACCTAATCC GACACCTAATCC
CTCATTTCTTCA	CTCATTTCTTCC CTCATTTCTTCC
TATACTCACGTC	TATACTCTCGTC TATACTCTCGTC
TATACTCTCGTC	TATACTCACGTC TATACTCACGTC
AACCGTTTCCAC	AACCGTATCCAC AACCGTATCCAC
CCTTAGAAGGTC	CCTTATAAGGTC CCTTATAAGGTC
CGCCACTATCTA	CCCCACTATCTA CCCCACTATCTA
TCGCTTCACTAT	TCGCTTAACTAT TCGCTTAACTAT
GAATACCATGGC	GAATACAATGGC GAATACAATGGC
GTCGGGGCGGGC	CTCGGGGCGGGC CTCGGGGCGGGC
ATGGTTCATTTG	ATGGATCATTTG ATGGATCATTTG
CCGCAAAAAACG	ACGCAAAAAACG CCGCANAAAACG ACGCAAAAAACG CCGCANAAAACG
TGTCTGAAGCTC	AGTCTGAAGCTC AGTCTGAAGCTC
GCCCTCCATCCA	GCCCTCCAACCA GCCCTCCAACCA
TAAATGAACCAC	TAAATGAATCAC GAAATGAACCAC GAAATGAACCAC TAAATGAATCAC
TATCATACAAAC	AATCATACAAAC AATCATACAAAC
CATTGGCCCACG	CAATGGCCCACG CAATGGCCCACG
ACCTAATCTTCA	ACCAAATCTTCA ACCAAATCTTCA
GCCAGGGTCGTC	GCCGGGGTCGTC GCCAGGGTCGTG GCCAGGGTCGTG GCCGGGGTCGTC
CCCTCCTACTGC	CCCTCCTGCTGC CCCTCCTGCTGC
AACTTACTCGAC	AACTAACTCGAC AACTTACTCGAG AACTAACTCGAC AACTTACTCGAG
TCAGTAACCATG	TCAGGAACCATG TCAGGAACCATG
TTACAGACGCGA	TTACAGACGCGG ATACAGACGCGA ATACAGACGCGA TTACAGACGCGG
CAAGCGTTTCTT	CAAGCGCTTCTT CAACCGTTTCTT CAAGCGCTTCTT CAACCGTTTCTT
TGAACGACGGTT	CGAACGACGGTT CGAACGACGGTT
TCGCCATTGCGC	ACGCCATTGCGC ACGCCATTGCGC
GACCTAGGTACA	GGCCTAGGTACA GGCCTAGGTACA
TCCTCCGCCTTT	TCATCCGCCTTT TCCTCCGCCATT TCCTCCGCCATT TCATCCGCCTTT
TCTGGACCCCCA	ACTGGACCCCCA ACTGGACCCCCA
ACGACTGTCAAC	ACGACTGTCCAC ACGACTGTCAAA ACGACTGTCCAC ACGACTGTCAAA
CTTCCTATGCTG	CTTCCTATGATG CTTCCTATGATG
AATTAGGGCCGT	AATCAGGGCCGT ATTTAGGGCCGT ATTTAGGGCCGT AATCAGGGCCGT
ATATCCCGGCCG	ATATCCCGGCCC AAATCCCGGCCG ATATCTCGGCCG ATATCCCGGCAG ATATCTCGGCCG AAATCCCGGCCG ATATCCCGGCAG ATATCCCGGCCC
TGCCCTTCCCTT	TGCCCTTCACTT TGCCCTTCACTT
TATTACGCATCC	TATTAAGCATCC TATTAAGCATCC
ATGGCCTTTGCG	ATGGCCTTAGCG ATGGCCTTAGCG
CACTTTACCAGC	CACTTTACCAGA CACTTTACCAGA
ACCCACGCGTCC	ANCCACGCGTCC ANCCACGCGTCC
TTACGCCGCAGT	TTACGCCGCAGG ATACGCCGCAGT ATACGCCGCAGT TTACGCCGCAGG
GCACCCGCGCCC	GCACCCGCGCAC GCACCCGGGCCC GCACCCGGGCCC GCACCCGCGCAC
CTCTTCATTCTT	CTCTTAATTCTT CTCTTAATTCTT
TCGCAACGACGA	ACGCAACGACGA ACGCAACGACGA
GTGGACACCGTA	GTGGCCACCGTA GTGGCCACCGTA
CCTACAATGGCT	CCTACNATGGCT CCTACNATGGCT
CTAGAAACCTAG	CTAGAAAACTAG CTAGAAAACTAG
CGTTGCCAATGT	CGTAGCCAATGT CGTAGCCAATGT
TGCGGGATCCCG	TGCGGAATCCCG TGCGGAATCCCG
TTCGAACACCAA	TTCGAACACAAA TTCGAACACAAA
CAAGGATTTATG	CAAGGAATTATG CAAGGAATTATG
TCGCATCCTTCG	ACGCATCCTTCG CCGCATCCTTCG CCGCATCCTTCG ACGCATCCTTCG
ACAACGAGCACA	ACAACGAACACA ACAACGAGCTCA ACAACGAACACA ACAACGAGCTCA
CTGTCGCCCACT	CTGTCGCCCACA CTGTCGCCCACA
TGCTCACTGATC	TGCACACTGATC TGCTCACTAATC TGCTCTCTGATC TGCTCTCTGATC TGCACACTGATC TGCTCACTAATC
TGCGCTTCCGGT	AGCGCTTCCGGT AGCGCTTCCGGT
TTTGTAGGCGGT	TTTGTAGGCGCT TTTGAAGGCGGT TTTGTAGGCGCT TTTGAAGGCGGT
TTGCACATTCTC	TTGCACATTCGC TTGCACATTCGC
TACGTTCGCGAC	TACGTCCGCGAC TACGATCGCGAC TACGATCGCGAC TACGTCCGCGAC
GTCTATGCCTCA	GACTATGCCTCA GACTATGCCTCA
AAGACACTCTGA	AAGACACTCTTA AAGACACTCTTA
TTCAGTACTCCA	ATCAGTACTCCA TTCAGTACTCAA TACAGTACTCCA TACAGTACTCCA TTCAGTACTCAA ATCAGTACTCCA
TTGCTCGCCTCG	TTTCTCGCCTCG TTACTCGCCTCG ATGCTCGCCTCG TTACTCGCCTCG ATGCTCGCCTCG TTTCTCGCCTCG
TCTAAGATCCAG	TCTAAGATCAAG TCTAAGAGCCAG TCTAAGAGCCAG TCTAAGATCAAG
TCATGTGAATTA	ACATGTGAATTA TCATGTGAATTG ACATGTGAATTA TCATGTGAATTG
GCAAAGTTTTCA	GCAAAGTGTTCA GCAAATTTTTCA GCAAATTTTTCA GCAAAGTGTTCA
AAAGTTCTATCC	AAAGTTCTATCT AAAGTTCTATCT
TTCCTGGTAGTG	TTCCAGGTAGTG TTCCAGGTAGTG
CATGTATCCTAG	CAAGTATCCTAG CAAGTATCCTAG
AACGACAGCTGG	AACGACAGCTAG AACGACAGCTAG
CTTCCGGTCACC	CTTACGGTCACC CTTACGGTCACC
CGCTTTTTGAAA	CTCTTTTTGAAA CTCTTTTTGAAA
CTACACTCCTGG	CTAAACTCCTGG CTAAACTCCTGG
CAATACATCGTC	CAATACATCGGC CAATACATCGGC
TCCAACAGCGTC	ACCAACAGCGTC ACCAACAGCGTC
CATACGGTAGTC	CATTCGGTAGTC CATTCGGTAGTC
GTCGCAGTCTAA	GTCGCAGTCAAA GTCGCAGTCAAA
GGAAAGCCGACC	NGAAAGCCGACC NGAAAGCCGACC
TCGCGGGTAATC	TCGCGTGTAATC TCGCGTGTAATC
TACGCTGTACCA	TACGCTGTAGCA AACGCTGTACCA AACGCTGTACCA TACGCTGTAGCA
TCCATCACATTC	TCCATCACATAC ACCATCACATTC ACCATCACATTC TCCATCACATAC
GCCCAATTTTCG	TCCCAATTTTCG CCCCAATTTTCG CCCCAATTTTCG TCCCAATTTTCG
AGCGCGTATCCC	AGCGCGTAACCC AGCGCGTATCCG AGCGCGTAACCC AGCGCGTATCCG
CTGGGCCCGTCC	CTGGGACCGTCC CTGGGACCGTCC
CATTAGACCCCC	AATTAGACCCCC AATTAGACCCCC CATGAGACCCCC CATGAGACCCCC
CATAATACTACA	TATAATACTACA TATAATACTACA
CCATCGGAACCC	CCATCGGAANCC CCATCGGAANCC
CAATTCGCACCC	CAAATCGCACCC CAATTNGCACCC CAATTNGCACCC CAAATCGCACCC
CCGTCCAGGATT	CCGTCCAGGAAT CCGTCCAGGAAT
TAGTCAAGAACA	AAGTCAAGAACA AAGTCAAGAACA
ATGTCTGTTGTC	TTGTCTGTTGTC TTGTCTGTTGTC
CGCCTCCGACCC	CGCCTCAGACCC CGCCTCCGACGC CGCCCCCGACCC CGCCACCGACCC CGCCCCCGACCC CGCCACCGACCC CGCCTCAGACCC CGCCTCCGACGC
GGAACTGGCTGC	GGAACTGGCAGC GGAAATGGCTGC GGAAATGGCTGC GGAACTGGCAGC
CCCCCCACCTTC	CCCCCCACATTC CCCCCCACATTC
ATAACGCGAAGG	ATAACACGAAGG ATAACACGAAGG
GATTAAGGGTTA	GATTTAGGGTTA GATTTAGGGTTA
AGGGGCTACAAT	AGGCGCTACAAT AGGCGCTACAAT
CGTTAAACGCCT	CGATAAACGCCT CGATAAACGCCT
GAACCTACCCTC	GAACCTATCCTC GAACCTATCCTC
CACATCTTCACT	CAAATCTTCACT CACATCTACACT CAAATCTTCACT CACATCTACACT
TCAGGCCAGTCC	TCAAGCCAGTCC ACAGGCCAGTCC TCAAGCCAGTCC ACAGGCCAGTCC
AGTTGCGCTCAT	AGTTGCTCTCAT AGTTGCTCTCAT
CACCGTATTAAC	CACCCTATTAAC CACCTTATTAAC CACCCTATTAAC CACCTTATTAAC
AACACTACAACC	AACACTACAAGC AACACTACAAGC
CCCGCCCAAGAA	CCCGACCAAGAA CCCGCCAAAGAA CCCGACCAAGAA CCCGCCAAAGAA
AAAGACTGCGTC	AAAGACTGCGTG AAAGACTGCGTG
AGGGCCCACATA	AGGGCCCACATG AGGGCCCACATG
GCTTACATGCAT	GCTTACATGCAG GCTTACATGCAG
AACCAAAGTACG	AACCAAACTACG AACCAAACTACG
TGCGAGTCTACC	TGCGAGTCTAGC TACGAGTCTACC TGCGAGTCNACC AGCGAGTCTACC TGCGAGTATACC TGCGAGTCTTCC TACGAGTCTACC TGCGAGTCNACC TGCGAGTATACC TGCGAGTCTAGC TGCGAGTCTTCC AGCGAGTCTACC
GTGCATAGTCCC	GTGCATAGTCCG GAGCATAGTCCC GAGCATAGTCCC GTGCATAGTCCG
TCCCTCCGCCTA	TCCCTCCGCATA TCCCTCCGCATA
TAACATGCAGGC	TAACATGCAGGA TAACATGCAGGA
TCGTTTCCCTCT	TCGATTCCCTCT TCGATTCCCTCT
CTACCGTCAAGA	CTACCGTCAACA CTACCGTCAACA
CATACGGCTTCT	CATACGGCCTCT CATACGGCCTCT
GATGGGATTTCT	GATGGGATTTCA GATGAGATTTCT GATGGGATTTCA GATGAGATTTCT
TTCCATTGGTTC	TTCCATAGGTTC ATCCATTGGTTC ATCCATTGGTTC TTCCATAGGTTC
GCCTATCGGGCA	GCCTATCGGGCG GCCTATCGGGCG
CGGTTCCGTATG	CGGTTCCGAATG CGGTTCCGTTTG CGGTTCCGAATG CGGTTCCGTTTG
TTTTGAATCCGT	ATTTGAATCCGT TTTTGAATGCGT ATTTGAATCCGT TTTTGAATGCGT
TTGGACGTCTCA	TTAGACGTCTCA TTAGACGTCTCA
CCATAGGTTTTC	CCAAAGGTTTTC CCAAAGGTTTTC
TTCCCGCGTCAG	NTCCCGCGTCAG NTCCCGCGTCAG
CAGCTCCTATCG	CAGCTCCTATAG CAGCTCCTATAG
CATTCCGTTACT	CATACCGTTACT CATTACGTTACT CATTCCGATACT CATACCGTTACT CATTACGTTACT CATTCCGATACT
AAACTTCTCCTG	AAACTTCACCTG AAACTTCTCCAG AAACTTCTCCAG AAACTTCACCTG
CCTAATACTCTA	TCTAATACTCTA CCTAAAACTCTA CCTAAAACTCTA TCTAATACTCTA
GTTCACTCCCCC	GTACACTCCCCC GTACACTCCCCC
CACCACGTAACC	CACAACGTAACC CATCACGTAACC CATCACGTAACC CACAACGTAACC
TATAGAGGCACC	TATAGAGGCACT TATAGAGGCACA TATAGAGGCACT TATAGAGGCACA
ACGATTATTTCC	TCGATTATTTCC TCGATTATTTCC
CGCAAGCTTTAC	CACAAGCTTTAC TGCAAGCTTTAC TGCAAGCTTTAC CACAAGCTTTAC
CAGGGAAATTGG	CAGGGAAAATGG CAGGGAAAATGG
GTACCTATCCTC	GAACCTATCCTC GTACCTATCCAC GTACCTATCCAC GAACCTATCCTC
GACACAAACCCA	GAAACAAACCCA GAAACAAACCCA
GGCACCCGAAAA	GACACCCGAAAA GGCACACGAAAA GACACCCGAAAA GGCACACGAAAA
TCAAACATCAGA	ACAAACATCAGA ACAAACATCAGA
GAGGACCGTCAT	GAGGACCGTCAG GAGGACCGTCAG
CCCAAACCCGCA	CCCAAACCCGGA CCCAAACCCGGA
GATAAATGCGCC	GATAAAAGCGCC GATAAAAGCGCC
CAACGCGTTGCC	CAACGCGTTGTC CAACGCGTTGTC
AATCACCTCGAG	AATCACCTCGAC AATCACCTCGAC
GAACCGCCGAAT	GAACCGCCGAGT AAACCGCCGAAT GAACCGACGAAT CAACCGCCGAAT GAACCGACGAAT CAACCGCCGAAT AAACCGCCGAAT GAACCGCCGAGT
CGCCACACTAGG	CGCCACACTAGC CGCCACACTAGC
TGTTCACGCCGC	TGTTCACGCAGC TGTTCACGCAGC
GGGTCGTAGATT	GGGTCGTAGNTT GGGTCGTAGNTT
TCCTTCTCCAAA	TCCATCTCCAAA TCCATCTCCAAA
CCGATCACCCCA	CCGATCACCACA CCGATCACCACA
CTCCCGGGAGGC	CTCCCGGGAGGG CTCCCGGTAGGC CTCCCGGTAGGC CTCCCGGGAGGG
TAATCTCTTAAT	TAATCTTTTAAT TAATCTTTTAAT
TCTGGTCGGCGC	ACTGGTCGGCGC ACTGGTCGGCGC
TCGTCTCTAGGT	ACGTCTCTAGGT ACGTCTCTAGGT
GGGCCTACTAGG	GGACCTACTAGG GGACCTACTAGG
GACGCTTGAACT	GACGCTAGAACT GACGCTAGAACT
GTTGCAATCCCT	GTTGCAATCCCG GTTGCAATCCGT GTTGCAATCCCG GTTGCAATCCGT
GTTTAACACCTG	GTATAACACCTG GTATAACACCTG
CGCCCAACAGCG	CGCCCAACATCG CGCCCAACATCG
TTCATAGTCACC	ATCATAGTCACC ATCATAGTCACC
TCAAAATATTTA	TCAAAATATATA ACAAAATATTTA TAAAAATATTTA ACAAAATATTTA TAAAAATATTTA TCAAAATATATA
TCACCCGCTGTC	TCACCCGCTTTC TCACCCGCTGGC TCACCCGCTTTC TCACCCGCTGGC
TGAAAATGACAT	AGAAAATGACAT AGAAAATGACAT
TCTTCCTACGGT	TCATCCTACGGT TTTTCCTACGGT CCTTCCTACGGT TTTTCCTACGGT TCATCCTACGGT CCTTCCTACGGT
TATCTACTCGGT	AATCTACTCGGT AATCTACTCGGT
TCAGTGCGGATC	ACAGTGCGGATC ACAGTGCGGATC
AAATCGGATTAG	AAAACGGATTAG AAAACGGATTAG
ACCCACAACATC	ACCCACAACAAC ACCCACAACAAC
ATCTCTTAATTG	ATCACTTAATTG ATCACTTAATTG
CCTTTTCGAGCC	TCTTTTCGAGCC TCTTTTCGAGCC
GAACACTTCCCC	GGACACTTCCCC GAACACTTGCCC GAACACTTGCCC GGACACTTCCCC
CTATACCCGAGT	CTAAACCCGAGT CTAAACCCGAGT
CAGCATCCAGCG	CTGCATCCAGCG CTGCATCCAGCG
CGCATGGCCGCA	CGCATGGCCGTA CGCATGGCCGTA
TCAAATCCTATA	TAAAATCCTATA TCAAATCCTAGA ACAAATCCTATA TCAAAGCCTATA TCAAATCCTAAA ACAAATCCTATA TCAAAGCCTATA TCAAATCCTAGA TAAAATCCTATA TCAAATCCTAAA
CTTACTAACTCG	CTTGCTAACTCG CTTGCTAACTCG
AGTCATATTCTA	AGACATATTCTA AGACATATTCTA
GAGTGCGTCACC	GAGTGCGACACC GAGTGCGTTACC GAGTGCGTTACC GAGTGCGACACC
TACACAAGGCGT	TACACAAGGAGT TACACAAGGAGT
CACTTCTCTTGG	CACATCTCTTGG CACTTCTCATGG CACTTCTCTTAG CACATCTCTTGG CACTTCTCTTAG CACTTCTCATGG
CTCCGTGTACCA	CTCCGTGTACCG CTCCGTGTACCG
TAGGCTCCCGAG	TACGCTCCCGAG TACGCTCCCGAG
ACCTTATCTTCT	ACCTTAACTTCT GCCTTATCTTCT ACCTTAACTTCT GCCTTATCTTCT
ACTGGAGTCTCA	ACTGGAGTCTCG ACTGGAGTCTCG
CAATATCTCGAC	CAATAACTCGAC CAATAACTCGAC
CCACTTACACTT	CCACTAACACTT CCACTAACACTT
CGGTTATCTTCT	CGGTGATCTTCT CGGTGATCTTCT
GCATAGTGCATA	GCATAGAGCATA GCATAGAGCATA
TATGCACCCCAA	AATGCACCCCAA AATGCACCCCAA
TTAGGCTAGGAC	ATAGGCTAGGAC ATAGGCTAGGAC
TTAGTACGGCGA	TTAGTACGGAGA TTAGTACGGAGA
ACTATTACACAG	ACTAATACACAG ACTAATACACAG
ATTTAAAAAGTC	ATTTAATAAGTC ATATAAAAAGTC ATTTAATAAGTC ATATAAAAAGTC
CTGTCCTCTACG	CTGTCTTCTACG CTGTCTTCTACG
CCCATTCACTTG	CCCAATCACTTG CCCAATCACTTG
CAAAGTCCCCAT	CAAAGTCCCCGT CAAAGTCCCCTT CAAAGTCCCCTT CAAAGTCCCCGT
CACCCAACTGTG	CACCCAACTGTC CACCAAACTGTG CACCAAACTGTG CACCCAACTGTC
AATTAAGGCAAA	AATTANGGCAAA AATTANGGCAAA
TCGAATGGCTTT	TCGAANGGCTTT TCGAANGGCTTT
TACCATCGCCCT	TACCANCGCCCT TACCANCGCCCT
TGATCCGTAACA	TGATCTGTAACA TGATCTGTAACA
GCACGCGTGAAA	GCACGAGTGAAA GCACGAGTGAAA
CAAATTAACGCC	TAAATTAACGCC TAAATTAACGCC
GGCCGGACCCCA	GGCCGGAGCCCA GACCGGACCCCA GGCCGGAGCCCA GACCGGACCCCA
TTGCCCTGGTAA	ATGCCCTGGTAA ATGCCCTGGTAA
GGTTATTATTAG	GGTTANTATTAG GGTTANTATTAG
TCCGTGACACCT	TCAGTGACACCT TCAGTGACACCT
CTAAGCCTCCGG	CAAAGCCTCCGG CTAAGCCTCCGT CAAAGCCTCCGG CTAAGCCTCCGT
ACCACCATAGTA	ACCACNATAGTA ACCAACATAGTA ACCAACATAGTA ACCACNATAGTA
GCCATTCGTCGT	GCAATTCGTCGT GCAATTCGTCGT
GGGATAGTGTTT	TGGATAGTGTTT GGGATAGTGTAT TGGATAGTGTTT GGGATAGTGTAT
ACTGTCACTCAT	ACTCTCACTCAT ACTCTCACTCAT
ATTCTGTACCAC	ATTCTCTACCAC ATTCTCTACCAC
GGTTCCAGCCTT	GGTACCAGCCTT GGTACCAGCCTT
TACTATCCACAC	TACTATCCACCC TACTATCCACAG TACTATCCACCC TACTATCCACAG
TCCTCCACAAAC	ACCTCCACAAAC TCCTCCACAATC ACCTCCACAAAC TCCTCCACAATC
TACTTTCTTACT	TACGTTCTTACT AACTTTCTTACT TACGTTCTTACT AACTTTCTTACT
ACTTGTATTAAA	ACTAGTATTAAA ACTAGTATTAAA
TTGGATGAGCTG	ATGGATGAGCTG CTGGATGAGCTG CTGGATGAGCTG ATGGATGAGCTG
TTCCCTCCCTGT	TTCCCTCCCAGT TTCCCTCACTGT ATCCCTCCCTGT ATCCCTCCCTGT TTCCCTCCCAGT TTCCCTCACTGT
GCCCATCGAGCT	GCCCATCGATCT GCGCATCGAGCT GCGCATCGAGCT GCCCATCGATCT
TCTCTGTATCTC	TCTCTGTATCAC TCTCTGTATCGC TCTCTGTATCAC TCTCTGTATCGC
AGGCCAAGATCT	AGGCCAAGAACT AGGCCAAGAACT
CATTATTAGCAC	CATTATTACCAC CAATATTAGCAC CATTAATAGCAC CATAATTAGCAC CATAATTAGCAC CATTAATAGCAC CAATATTAGCAC CATTATTACCAC
CACTGGGGCATC	CACTGNGGCATC CACTGTGGCATC CACTGTGGCATC CACTGNGGCATC
GGTCTCGTGGTA	GATCTCGTGGTA GATCTCGTGGTA
TCGTGGTTCACA	TCGTGCTTCACA TCGTGCTTCACA
ATTTATTTCGGC	ATTTATTCCGGC ATTTATTCCGGC
GATCACCCAGCG	GATCACACAGCG GATCACACAGCG
AAGCATTCTCTG	AAGCATTCTCGG AAGCATTCTCGG
ACTTCTCTCCCG	ATTTCTCTCCCG ATTTCTCTCCCG
TGAAGCCCGTTA	TGNAGCCCGTTA AGAAGCCCGTTA AGAAGCCCGTTA TGNAGCCCGTTA
TGTGGGCCCCAG	AGTGGGCCCCAG AGTGGGCCCCAG
GGGATCCGCCCT	GGGATCAGCCCT GGGATCAGCCCT
AACACGGCCCCG	AAAACGGCCCCG AACACTGCCCCG AAAACGGCCCCG AACACTGCCCCG
ACTCCCCTCCAC	ATTCCCCTCCAC ACTCCCCTCCAT ATTCCCCTCCAC ACTCCCCTCCAT
GATCTCCCAGGA	CATCTCCCAGGA GATCTCCCAGAA CATCTCCCAGGA GATCTCCCAGAA
CTAGTTTTTTAC	TTAGTTTTTTAC TTAGTTTTTTAC
TACCCCTGACCT	AACCCCTGACCT AACCCCTGACCT
TAGAGCCAACCA	AAGAGCCAACCA AAGAGCCAACCA
TAACAACGTCGA	AAACAACGTCGA AAACAACGTCGA TAACAACGACGA TAACAACGACGA
AAACAACGTCGA	AAACAACCTCGA AAACAACCTCGA
TCAAACGTAGCG	TCAAACGAAGCG TCAAACGAAGCG
CTAACGACGCCA	CTAACGACGCCT CTAACGACGCCT
GGCAAACCAAAT	CGCAAACCAAAT CGCAAACCAAAT
CCCTACGCCCTT	CCCTACCCCCTT CCCTACGCCCTG CCCTACCCCCTT CCCTACGCCCTG
ACCCCACCAGGA	NCCCCACCAGGA NCCCCACCAGGA
ATTGACGCATTT	AATGACGCATTT AATGACGCATTT
TATAGAGGCACT	TATAGAGGCACA TATAGAGGCACA
TATAGAGGCACA	TATAGAGGCACT TATAGAGGCACT
CAAAGTCCCCTT	CAAAGTCCCCGT CAAAGTCCCCGT
CAAAGTCCCCGT	CAAAGTCCCCTT CAAAGTCCCCTT
CCCGTTTTGGCT	TCCGTTTTGGCT CCCGGTTTGGCT CCCGTTATGGCT CCCGTTTTGGCG TCCGTTTTGGCT CCCGTTTTGGCG CCCGTTATGGCT CCCGGTTTGGCT
CGCAATTACATC	CGCAATTACATA CGCAATTACATA
CTCGGATCCCGT	CTCGCATCCCGT CACGGATCCCGT CTCGCATCCCGT CACGGATCCCGT
TCGGGACGCCGC	TCGGGAAGCCGC TCGGGAAGCCGC
CACTGGGATTTG	CACTTGGATTTG CACAGGGATTTG CACTGGGATATG CACTTGGATTTG CACAGGGATTTG CACTGGGATATG
ACATTTATTGTC	ACATATATTGTC ACATATATTGTC
ACTGTAGCCAAT	ACTGAAGCCAAT ACTGTAGCCAGT TCTGTAGCCAAT ACTGAAGCCAAT TCTGTAGCCAAT ACTGTAGCCAGT
TCACTTTGTACC	TCATTTTGTACC TCATTTTGTACC
CTGGCCCCCCTC	CTGGCCCCCGTC CTGACCCCCCTC CTGACCCCCCTC CTGGCCCCCGTC
CAGCCCGTTTAC	CGGCCCGTTTAC CGGCCCGTTTAC
ACAGGGGGCGAC	ACAGGGGTCGAC ACAGGGGTCGAC
TCGACGACGGGC	TTGACGACGGGC ACGACGACGGGC TTGACGACGGGC ACGACGACGGGC
TCCGCCTCCGTG	TCCGCATCCGTG TCCGCATCCGTG
ATCGCCTGCTTC	AACGCCTGCTTC AACGCCTGCTTC
GTAGTTCTACAC	GAAGTTCTACAC GTAGTTTTACAC GAAGTTCTACAC GTAGTTTTACAC
GACCAGTCTAAT	GACCAGTATAAT GACCAGTATAAT
CACGGCCTAACC	GACGGCCTAACC GACGGCCTAACC
ACGATGATCATC	ACGAAGATCATC ACGAAGATCATC
TGAGCAATCTGT	TAAGCAATCTGT TAAGCAATCTGT
TAAGCAATCTGT	TGAGCAATCTGT TGAGCAATCTGT
TCGATACTTCAT	ACGATACTTCAT TAGATACTTCAT ACGATACTTCAT TAGATACTTCAT
ACCTCTTGATAT	ACCTCTTGATGT ACCTCTTGATGT
CATTCGACCACA	CATACGACCACA CATACGACCACA
TCTCCTTTTAAT	GCTCCTTTTAAT GCTCCTTTTAAT
TTTTGGACCTCC	ATTTGGACCTCC ATTTGGACCTCC
CTGAGCATAGCA	CTGAGCATAGGA CTGAGCATAGGA
CTTTACCTTGCT	CTTTACCTCGCT CTTTACCTCGCT
TGTTCAACTGTC	CGTTCAACTGTC TGCTCAACTGTC CGTTCAACTGTC TGCTCAACTGTC
CACGGTCCGACT	CACGGTACGACT CACGGTCCGACC CACGGTACGACT CACGGTCCGACC
CGCAATGCTATA	CGCAATCCTATA CGCAATCCTATA
CCTAAGTAGATC	CCTAAGTAGAAC CCTAAGTAGAAC
TATACCTATATA	AATACCTATATA AATACCTATATA
CTTGGAGGCAAC	CTTGGNGGCAAC CTTGGNGGCAAC
GTCGATCAGGCT	NTCGATCAGGCT NTCGATCAGGCT
CTTATTTGTGGT	CTTATATGTGGT CTTATATGTGGT
TCGTATGCCTCC	TCGTATGCCTCG TCGTATGCCTCG
CCATCGGCCTAC	CCATCGGCCTGC CCATCGGCCTGC
GCGGCTTGTGAG	GCGGCTTGTAAG GCGGCTTGTAAG
AGGGCCTATTAT	GGGGCCTATTAT ATGGCCTATTAT ATGGCCTATTAT GGGGCCTATTAT
CATACCAGTGAT	CAAACCAGTGAT CATACCAGTGAG CATACCAGTTAT CAAACCAGTGAT CATACCAGTTAT CATACCAGTGAG
TCTGATTTCCTG	TCTGATTTCCTC TCTGATTTCCTC
TCCTACCAATTC	TCCAACCAATTC TCCAACCAATTC
TCTCACTCGAGC	ACTCACTCGAGC ACTCACTCGAGC
GCGCAGTTCATT	GCGCAGTTCATG GCGCAGTTCATG
AAAACGATATGC	AAAATGATATGC AAAATGATATGC
TATACAAGCCAA	TAAACAAGCCAA AATACAAGCCAA TAAACAAGCCAA AATACAAGCCAA
CTCCCACTTAAT	CTCCCGCTTAAT CTCCCGCTTAAT
CATGGCGAGCCT	CAAGGCGAGCCT CAAGGCGAGCCT
CATGGCGAGCAT	CATGGCGAGCCT CATGGCTAGCAT CATGGCGAGCCT CATGGCTAGCAT
CAGCTACCATAG	CAGCAACCATAG CAGCAACCATAG
CCCGCAACCGTA	CCCGCAACTGTA CCCGCAACTGTA
CTGCAAACCGCA	CTGCATACCGCA CTGCAAACAGCA CTGCAAACAGCA CTGCATACCGCA
TATTAGCTCACT	TATTAGCTCGCT TATTAGCTCGCT
TATTAGCTCGCT	TATTAGCTCACT TATTAGCTCACT
TATTAGCTCCCT	TATTAGCTCACT TATTAGCTCACT TATTAGCTCGCT TATTAGCTCGCT
TGGTGTAGATTC	TGGTGTTGATTC TGGTGTTGATTC
ACATCCATATTC	ACATCCAAATTC ACATCCATAATC ACATCCATAATC ACATCCAAATTC
CCCCAATTTTCG	TCCCAATTTTCG TCCCAATTTTCG
GCATCGCAACGT	GCATAGCAACGT GCATCGCAANGT GCATCGCAANGT GCATAGCAACGT
GTTACGCTTCGC	GTGACGCTTCGC GGTACGCTTCGC GGTACGCTTCGC GTGACGCTTCGC
CTTCTGAGACCT	CATCTGAGACCT CATCTGAGACCT
TCCTTACGTCAT	TCCTTACGTCAG TCCTTACGTCAG
CTGTTTATACCT	CGGTTTATACCT CCGTTTATACCT CCGTTTATACCT CGGTTTATACCT
CCTCACCCATAA	CCTCAACCATAA CCTCAACCATAA
TCTGTCTATCAT	ACTGTCTATCAT ACTGTCTATCAT
CAACCGCCGAAT	AAACCGCCGAAT AAACCGCCGAAT
AAACCGCCGAAT	CAACCGCCGAAT CAACCGCCGAAT
ACTTATCTGGAT	ACTTATCTGGAG ACTTATCTGGAG
TTTTTTATGGCA	ATTTTTATGGCA ATTTTTATGGCA
GGAATCAAGGTC	AGAATCAAGGTC AGAATCAAGGTC
GTTAACTCAAAA	GATAACTCAAAA GATAACTCAAAA
TTCTGGGTACTC	TTCTAGGTACTC TTCTGGGTACTG TTCTAGGTACTC TTCTGGGTACTG
TTCGTTGTCAGC	TTCGTTGTCAGG TTCGTTGTCAGG
ACACGATACCCG	ACACGATACNCG ACACGATACNCG
CTGATTATCATT	ATGATTATCATT ATGATTATCATT
CACTCGCAGCTG	CCCTCGCAGCTG CCCTCGCAGCTG
GCCAATTGTTGC	GCCAATTGTAGC GCCAATTGTAGC
ACGTTACGACCA	ACGTAACGACCA ACGTTACGACTA ACGTTACGANCA ACGTAACGACCA ACGTTACGANCA ACGTTACGACTA
TACCAGTTCTCC	TACAAGTTCTCC AACCAGTTCTCC AACCAGTTCTCC TACAAGTTCTCC
GGCTACCCTTTA	GGATACCCTTTA GGATACCCTTTA
CTCTATCAATGC	CTCGATCAATGC CTCGATCAATGC
TCCAAGACTTCT	TCAAAGACTTCT TCAAAGACTTCT
ATGGTCGCCCGA	ATGGACGCCCGA ATGGACGCCCGA
TAGTTTTTTGGT	TAGTTTATTGGT TAGTTTATTGGT
GACAGGTTCCAC	GACAGCTTCCAC GACAGCTTCCAC
AACCAGTTCTCC	AACCAGTACTCC AACCAGTACTCC
AACCAGTACTCC	AACCAGTTCTCC AACCAGTTCTCC
TGTACTTACTCT	AGTACTTACTCT AGTACTTACTCT
CTTGCCTCTGGA	GTTGCCTCTGGA CTTGCTTCTGGA GTTGCCTCTGGA CTTGCTTCTGGA
TATCTCGCCTTT	TATCTCGCCTAT TATCTCGCCTAT
GTTCCCTACCTG	GTTCCCTACATG GTTCCCTACATG
TTACTCGCCTCG	TTTCTCGCCTCG TTTCTCGCCTCG
TTTCTCGCCTCG	TTACTCGCCTCG TTACTCGCCTCG
TACAGCTTACAC	AACAGCTTACAC AACAGCTTACAC
TATGAGTGCTAG	AATGAGTGCTAG AATGAGTGCTAG
CATTCACGTTCA	CATTCACGTTGA CATTCACGTTGA
CACCTTCGCGCA	CCCCTTCGCGCA CCCCTTCGCGCA
CACCGCATCTCA	CACCGCACCTCA CACCGCACCTCA
CTGGATGAGCTG	ATGGATGAGCTG ATGGATGAGCTG
ATGGATGAGCTG	CTGGATGAGCTG CTGGATGAGCTG
CGCCCCCGACCC	CGCCACCGACCC CGCCACCGACCC
CGCCACCGACCC	CGCCCCCGACCC CGCCCCCGACCC
GCTACCACACCA	GCTACCACACAA GCTACCACACAA
ATCAGAACTTAC	AACAGAACTTAC AACAGAACTTAC
AGTTAAGACCTT	AGTTAAGACTTT AGTTAAGACGTT AGTTAAGACGTT AGTTAAGACTTT
CGACAATAGGCT	CGACAATACGCT CGACAATACGCT
AGTACATACTCT	AGTACTTACTCT AGTACTTACTCT
AGTACTTACTCT	AGTACATACTCT AGTACATACTCT
ATGTATCTGGTC	ATGTATATGGTC ATGTATATGGTC
CACCCTATTAAC	CACCTTATTAAC CACCTTATTAAC
TACGATCGCGAC	AACGATCGCGAC AACGATCGCGAC
AACGATCGCGAC	TACGATCGCGAC TACGATCGCGAC
CCTTCTAGTGTG	CCATCTAGTGTG CCTTCTAGTCTG CCATCTAGTGTG CCTTCTAGTCTG
CGTCAAAATACT	CGACAAAATACT CGACAAAATACT
CTTAAAGCACCC	CTTAAAGCTCCC CTTAAAGCTCCC
CTTAAAGCTCCC	CTTAAAGCACCC CTTAAAGCACCC
ACAAAATATTTA	ACAAAATATTAA ACAAAAAATTTA ACAAAATATTAA ACAAAAAATTTA
ATAGGCACCCTT	AAAGGCACCCTT AAAGGCACCCTT
CCCTCTGCACTA	TCCTCTGCACTA TCCTCTGCACTA
AACAGCCCCTAT	TACAGCCCCTAT TACAGCCCCTAT
TACAGCCCCTAT	AACAGCCCCTAT AACAGCCCCTAT
CATTACCTTGTC	CATTACCTTTTC AATTACCTTGTC CATTACCTTTTC AATTACCTTGTC
ACGACGACGGAC	ACGACGACGGGC ACGACGACGGGC
ACGACGACGGGC	ACGACGACGGAC ACGACGACGGAC
TGCCTCCTTAGT	AGCCTCCTTAGT AGCCTCCTTAGT
AGCTAGTCCAAA	AGCTAATCCAAA AGCAAGTCCAAA AGCTAATCCAAA AGCAAGTCCAAA
ACGCATCCTTCG	CCGCATCCTTCG CCGCATCCTTCG
CACTGTGGCATC	CACTGNGGCATC CACTGNGGCATC
CACTGNGGCATC	CACTGTGGCATC CACTGTGGCATC
TAAACGTGGTTG	TAAACGTCGTTG TAAACGTCGTTG
GCATAAATGTCC	GCCTAAATGTCC GCCTAAATGTCC
GCCTAAATGTCC	GCATAAATGTCC GCATAAATGTCC
TCCAAATTTTCG	TCCCAATTTTCG TCCCAATTTTCG
TCCCAATTTTCG	TCCAAATTTTCG TCCAAATTTTCG
CAATTAAACAAC	CAATTAAACAAG CAATTAAACAAG
CAATTAAACAAG	CAATTAAACAAC CAATTAAACAAC
CAACTGGCAGTT	CAACTGGCAGTG CAACTGGCAGTG
ATGGATCATTTG	ATGGATCAATTG ATGGATCAATTG
ATGGATCAATTG	ATGGATCATTTG ATGGATCATTTG
CACAAAGTAACC	CACAACGTAACC CACAACGTAACC
CACAACGTAACC	CACAAAGTAACC CACAAAGTAACC
GTACCTATCCAC	GAACCTATCCAC GAACCTATCCAC
GAACCTATCCAC	GTACCTATCCAC GAACCTATCCTC GTACCTATCCAC GAACCTATCCTC
TCTTCCTTAGTA	TCCTCCTTAGTA TCCTCCTTAGTA
TCCTCCTTAGTA	TCTTCCTTAGTA TCTTCCTTAGTA
GAACCTATCCTC	GAACCTATCCAC GAACCTATCCAC
TCCACCGCGCAT	TCCACCGCCCAT TCCACCGCCCAT
AGTTAAGACGTT	AGTTAAGACTTT AGTTAAGACTTT
AGTTAAGACTTT	AGTTAAGACGTT AGTTAAGACGTT
GCTTGACCGAGT	GCTAGACCGAGT GCTAGACCGAGT
GCTAGACCGAGT	GCTTGACCGAGT GCTTGACCGAGT
AACCGTATCAAC	AACCGTATCCAC AACCGTATCCAC
AACCGTATCCAC	AACCGTATCAAC AACCGTATCAAC
CCCCCCACATTC	CCCCCCACATAC CCCCCCACATAC
CCCCCCACATAC	CCCCCCACATTC CCCCCCACATTC
ACATCTATCAAT	GCATCTATCAAT GCATCTATCAAT
CCGTTTATACCT	CGGTTTATACCT CGGTTTATACCT
CGGTTTATACCT	CCGTTTATACCT CCGTTTATACCT
TCTCTGTATCAC	TCTCTGTATCGC TCTCTGTATCGC
TCTCTGTATCGC	TCTCTGTATCAC TCTCTGTATCAC
TCAAATCCTAGA	TCAAATCCTAAA TCAAATCCTAAA
TCAAATCCTAAA	TCAAATCCTAGA TCAAATCCTAGA
TCCATCACATAC	TCCATAACATAC TCCATAACATAC
TCCATAACATAC	TCCATCACATAC TCCATCACATAC
GGCCGCTTTAAA	GGCCGCATTAAA GGCCGCATTAAA
TTCGTATCGGAA	TTCGTATCGGAT TTCGTATCGGAT
ACGTGATTGCAA	ACGTGATTTCAA ACGTGATTTCAA
CCCCAGGTCTGA	CCCCAGGTCTGT CCCCAGGTCTGG CCCCAGGTCTGC CCCCAGGTCTGT CCCCAGGTCTGG CCCCAGGTCTGC
TCTCTCCCTACA	TCTCTNCCTACA TCTCTNCCTACA
TTGCCCCGCTTA	TTGCCCCGCTTG TTGCCCCGCTTG
CGCTGTATGGTA	CGCTGTATGGTG GGCTGTATGGTA GGCTGTATGGTA CGCTGTATGGTG
CATCACCCGTGA	CATCCCCCGTGA CATCCCCCGTGA
TGGTCGACCGAA	AGGTCGACCGAA GGGTCGACCGAA GGGTCGACCGAA AGGTCGACCGAA
TCGGACTTGAGA	TCGGACTTTAGA TCGGACTTTAGA
TGTTCGATTCCA	AGTTCGATTCCA TGTTCGATTCCG AGTTCGATTCCA TGTTCGATTCCG
CGTCACGTACTA	CTTCACGTACTA CTTCACGTACTA
CCCTCTCGTTTA	TCCTCTCGTTTA CCCTCTCGATTA CCCTCTCGATTA TCCTCTCGTTTA
TTCTCGGATTGA	TTATCGGATTGA TTATCGGATTGA
CCAGTCTCAGTA	CCAGACTCAGTA CCAGACTCAGTA
CGATTGTCCCAA	CCATTGTCCCAA CCATTGTCCCAA
TATTCCGAACCA	TGTTCCGAACCA TGTTCCGAACCA
CCTGCCTATTCA	CCTGCCTATACA CCTGCCTATACA
GCTAATTCAATA	GCTAAATCAATA GCTAAATCAATA
GCAAGCCCATGA	GCAAGCCAATGA GCAAGCCAATGA
GCGCTGCGATCA	GCGCAGCGATCA GCGCAGCGATCA
CTCGGAAACCAA	CTCGGAAACCAG CTCGGAAACCAG
GGCCTATCTCCA	GGCCTATCTCAA GGCCTATCTCAA
CAAAAATGAATA	CAAAAATGATTA CAAAAATGATTA
CTCCCAATCCAA	CTCGCAATCCAA CTCGCAATCCAA
TCCCGATTGCCA	ACCCGATTGCCA TCCCGATTGCGA ACCCGATTGCCA TCCCGATTGCGA
GACCTAACCCCA	GACATAACCCCA GACATAACCCCA
AACACGATCCCG	AACACGATCCCC AACACGATCCCC
TTCGTTTCTCGC	TTCGTTTCTCGT TTCGTTTCTCGT
TCCCTGCATCCA	TCCCTACATCCA TCCCTACATCCA
ACACTCGTAGTA	ACACTTGTAGTA NCACTCGTAGTA ACACACGTAGTA ACAATCGTAGTA ACAATCGTAGTA ACACACGTAGTA NCACTCGTAGTA ACACTTGTAGTA
CGAGAAAGTTTA	CGAGAAAGTATA CGAGAAAGTATA
TTGCTCCTTTAA	ATGCTCCTTTAA ATGCTCCTTTAA
TATATTGAATCA	TATATTGAGTCA TATATTGAGTCA
TCCTTCGACAAA	ACCTTCGACAAA ACCTTCGACAAA
TGTTTCCCTTCA	TGTTTCCCTGCA TGTTTCCCTGCA
TTTTACAATGTA	ATTTACAATGTA TTATACAATGTA TTATACAATGTA ATTTACAATGTA
CTCCACATGTCA	CTCCACATTTCA CACCACATGTCA CTCCACATTTCA CACCACATGTCA
GGTCTTTCAATA	GGTCTTTCAAGA GGTCTTTCAAGA
TACTTCCTTCAA	AACTTCCTTCAA AACTTCCTTCAA
TACAAGGGCCCA	AACAAGGGCCCA AACAAGGGCCCA
TCGTCGCGACCA	ACGTCGCGACCA TCGTCGCAACCA TCGTCGCAACCA ACGTCGCGACCA
ATAAATGGCTCA	AAAAATGGCTCA AAAAATGGCTCA
TACTCCCGCTAA	TACACCCGCTAA AACTCCCGCTAA AACTCCCGCTAA TACACCCGCTAA
AGATGACCAAGA	AGATGATCAAGA AGATGATCAAGA
TATCTTAGCCCA	TAACTTAGCCCA TAACTTAGCCCA
CCTCACCCGGCG	CCTCACCCCGCG CCTCCCCCGGCG CCTCCCCCGGCG CCTCACCCCGCG
ACAGCCCCGGCA	ACAGCCTCGGCA CCAGCCCCGGCA ACAGCCTCGGCA CCAGCCCCGGCA
CGCGGCCGCGTA	TGCGGCCGCGTA TGCGGCCGCGTA
TCCTACTAGTGA	TCCTACTACTGA TCCTACTAGTTA TCCTACTACTGA TCCTACTAGTTA
CGGATGTTTCAA	CGGATGATTCAA CGGATGATTCAA
CATATCTTTGTA	CATAACTTTGTA CATAACTTTGTA
GCGATTCTGACA	GCGATTCTTACA GCGATTCTGAGA GCGATTCTTACA GCGATTCTGAGA
CCGGAGCCTTGA	TCGGAGCCTTGA TCGGAGCCTTGA
TCGGCGCTAACA	TAGGCGCTAACA TAGGCGCTAACA
TAGGCGCTAACA	TCGGCGCTAACA TCGGCGCTAACA
GGGTCGACCGAA	AGGTCGACCGAA AGGTCGACCGAA
AGGTCGACCGAA	GGGTCGACCGAA GGGTCGACCGAA
CACCACAAGTCA	CACCACATGTCA CACCACATGTCA
CACCACATGTCA	CACCACAAGTCA CACCACAAGTCA
CTGACGTCTCAA	CTGACGTCTCTA CTGACGTCTCTA
CTGACGTCTCTA	CTGACGTCTCAA CTGACGTCTCAA
CCCCAGGTCTGT	CCCCAGGTCTGG CCCCAGGTCTGC CCCCAGGTCTGG CCCCAGGTCTGC
CCCCAGGTCTGG	CCCCAGGTCTGT CCCCAGGTCTGT CCCCAGGTCTGC CCCCAGGTCTGC
CCCCAGGTCTGC	CCCCAGGTCTGT CCCCAGGTCTGG CCCCAGGTCTGT CCCCAGGTCTGG
AATGAGTGCTAG	AAAGAGTGCTAG AAAGAGTGCTAG
AAAGAGTGCTAG	AATGAGTGCTAG AATGAGTGCTAG
TTCCCACACAAT	TTACCACACAAT TTACCACACAAT
TACGGGACGATG	AACGGGACGATG AACGGGACGATG
TTCATTATTAAT	TTCATTATTAAA TTCATTATTAAA
CCCGACCGAATG	CCCGACCGAATA NCCGACCGAATG NCCGACCGAATG CCCGACCGAATA
TAATATCCTCAT	TAATATACTCAT TAATATACTCAT
CTAGGCCCGATG	CTAGGGCCGATG CTAGGGCCGATG
ATCATTTTGATG	ATCATTTTGATC TTCATTTTGATG ATCATTCTGATG ATCATTTTGATC TTCATTTTGATG ATCATTCTGATG
TGGTACTGAGAT	TGGAACTGAGAT AGGTACTGAGAT AGGTACTGAGAT TGGAACTGAGAT
GTTATTTTAGAT	GTTATTTAAGAT GTTATTTAAGAT
GTCCCCCTTAAT	GTCCCCCTAAAT GTCCCCCTAAAT
TGCATGCGGCAT	TGCATGCGGGAT TGCATGCGGGAT
CAGCATACTTAT	CAGCATACTTAA CATCATACTTAT CAGCATACTTAA CATCATACTTAT
TGATAAATGTAT	TGATAAATGTGT TGATAAATGTGT
TACCCATGTCAT	AACCCATGTCAT AACCCATGTCAT
ATGACGCCTCAT	ATGACGCCGCAT ATGACGCCGCAT
TACACGGAAACT	AACACGGAAACT AACACGGAAACT
GACGCCACGGAT	GCCGCCACGGAT GCCGCCACGGAT
CAGCCTCTACAT	TAGCCTCTACAT CAGCCACTACAT CAGCCACTACAT TAGCCTCTACAT
GCAAATGCCAAT	GCAAATGCCTAT GCAAATGCCTAT
ACTCCATAGAAT	ACTCCATTGAAT ACTCCATTGAAT
CCTGGTTTCTAT	CCTGGTATCTAT CCTGGTATCTAT
CCGCTGCGATAT	CCGTTGCGATAT CCGTTGCGATAT
GCCCAACGCTTT	GCCCAACGCTAT GCCCAACGCTAT
CTAAAGTGGGAT	CAAAAGTGGGAT CAAAAGTGGGAT
TTCCCGCTTCAT	TTCACGCTTCAT TTCACGCTTCAT
CACGAACCCTAT	CACGAACCGTAT CACGAACCGTAT
TGACCGACCCAT	TGACCGACACAT TGACCGACACAT
CTCGGGCCTATG	TTCGGGCCTATG CTCGCGCCTATG CACGGGCCTATG CTCGCGCCTATG CACGGGCCTATG TTCGGGCCTATG
TTCGCCTTCATG	TTCCCCTTCATG TTCCCCTTCATG
CCTTCTCTAATG	CCTTCTCTAATC CCTTCTCAAATG CCTTCTCTAATC CCTTCTCAAATG
CACGTCGACCTG	CACGTCGACCGG CACGTCGACCGG
ACATCTCTCATG	ACATCTCTCAGG ACATCTCTCAGG
CGAAACCAAATG	CCAAACCAAATG CCAAACCAAATG
TAACACACGATG	TAACACACGAAG AAACACACGATG AAACACACGATG TAACACACGAAG
TCCGCGAACCAT	ACCGCGAACCAT ACCGCGAACCAT
GACTCGCGATGG	GACTCGGGATGG GACTCGGGATGG
GTGAACTAATGG	GTGAACTAAAGG GAGAACTAATGG GAGAACTAATGG GTGAACTAAAGG
TGGCTTGGAGCG	TGGCTTGGAGGG TGGCTTGGAGGG
GCACCTACATGG	GAACCTACATGG GAACCTACATGG
CACCAACTATGG	CACCAACTATGC CACCAACTATGC
